###########################################
#                                         #
# !                   !                 ! #
#       #                            #    #
#       #     !            !      !  #    #
#     ###                            #    #
#     ###         !                  #    #
#     ##   !                 !       #    #
#                                    #    #
#                                         #
#     !            AAAAAA                 #
# !                AAAAAA             !   #
#         !                   !           #
#                                         #
#                                   !     #
#              !       !                  #
#   ######                                #
#                                     !   #
#                   !    ########         #
#        !                #######         #
#  !                                      #
#                                 !       #
###########################################
